............
........0...
.....0......
.......0....
....0.......
......A.....
......A.AA..
.......A....
.......AA...
.....0A..A..
..........A.
............